NO ./maps/afternoon_1.xpm
WE ./maps/afternoon_2.xpm
EA ./maps/afternoon_3.xpm
SO ./maps/afternoon_4.xpm
F 255, 187, 198
C 170, 122, 85

        1111111111111111111111111
  111   1011000001110000001000001     1
11101   1001000000000000001000001    101   11111111111
111011111011000001110000000000001    1001  10000000001
100000000011000001110111111111111    10001110000000001
11110111111111011100000010001        10000001010111001
1111010000011101110101001000011111111100000000001110001
110000001101010111000E001000000000000000000000000000001
100110000000000011100000110011111111110101010101010101
10000000000000001 11010010001        100000000000000001
1100000111010101 101111000111        100010100010000101 
11110111 1110101 111110110001        111100000000000001
11111111 1111111 11111111111            111101000011111
                        1111111111111111111000000000011
                        1000000000000000000000000000001
                        111111111111111111111111111111

